o..o..o...D...o..
...D...D..oDo...o
.........o.o.oo..
ooo....ooDo......
 ....o...oo......
. .o.o..o........
D..D.D........o.o
o....o.oo.o....o.
..... o.D. o.....
.o....... o.... .
....o....o..oD..o
oo....D...oooooo.
....o...o o..Doo.
....o....... Do..
o.D.D............
.........o.oo .o.
..o..D...DD.....o
o...o..D..o....oo
Do......o.......D
.oo........ooo ..
.....o .Doo.o.o.o
.. o.o....o. .o..
o...  o .........
o...ooD. o. ....o
.......o....oo.oo
