.........oD.o.o o
.....o..........o
....o........... 
 ...Do .o.D......
...o...o...o....o
..o.o.o .........
.....ooo...... .o
.o.o o. .........
. ...o......o.. .
......o.o......o.
.D..........o.D..
.oD.o.......D.Do.
......... .o....o
..ooo..o...D...o.
 oD... .o..o..o .
..o..oo..o......o
.o.... .DooDo....
o oo.o....oo...o.
.Doo.. ..D....o..
o.. o.. .o...o...
D....oD.. .D.D...
.....D.oo.o...o..
...........D.o...
..o...oo.....o..D
...o.....o.o.oo. 
