.D.....D......oo.
....oo Do....o...
..o..... ....oo..
.Do.......o.o.D.o
....o.oooo...o .D
.... ..oo.o......
....o ..o.....o.o
.o o.....oD.....o
..o..........oDo.
. .o. .oo.....o..
....D......o..Do.
D.. o..o.....Do..
......o...o.....o
......o.....o....
o...o.o.. oo.D...
o.D.o...o....o.oD
.....Doo..D......
oD..D...o...o....
.......o...Do..o.
.......o.oo.....o
 ......o. .....oo
 .o .D... ..D...o
. .o....D.o.....o
..  o... ....o...
D..D.........o...
