......D.oo... .o.
..Do.. .D. .D....
.....Do...oD...o.
 .. ...o. ..o.o..
........o.....o.o
.o...o....o.o. .o
. ..oo.......o...
.. .o..o...oD.. o
.o..oD.....o....o
.o....o...oo..o.o
....o.oo...D.....
o...o......oo... 
oo...oo.o.....o..
....o..Do....o...
..oo...o....o...o
oo.. .o.o.......o
o....o..oD.oo.. D
 ..D..D.....DoD..
......oD....D. ..
.o.o. o. ...o...o
...o...D. .....Do
......o.oo. .. ..
......oooD...o..o
 ...........o....
 oo.......o.. oo.
