.. .....DD.oo..oo
...o.o.o. ...o...
o..o...o.o.o...o.
.. ..oo.....o..oo
....o.o. D.......
o ...o...o....o .
oo.D.D...ooD.....
....Do..o.......o
o.... ....o.o...o
....o. ...oo...o.
.o.. ..D.o ooD..o
.o .D.oo ... .. .
..o...o...Doo.o.o
.ooo.oo..o....oo.
....o....oo .....
...oDo.o...oo..D.
o......oo .oooD..
D.o.oo....o. ..Do
...o.....oD....o.
... .. o.o .o..oD
.o.......D.. o...
.oo .o.....o.....
... o.o........o.
..D.....D.ooD. D.
.o....o...D... D.
